
██████████████████████████████████████████████████
██████████████████████████████████████████████████
                                ██              ██
██████████████████████████████  ██  ██████████████
██  ██  ██              ██  ██          ██  ██  ██
██  ██  ██████████████  ██  ██  ██████████  ██  ██
██      ██  ██  ██  ██                          ██
██████  ██  ██  ██  ██████  ██████████  ██  ██████
██                                  ██  ██      ██
██████  ██████████  ██  ██  ██  ██████████  ██  ██
██      ██          ██  ██  ██          ██  ██  ██
██  ██  ██████████  ██████  ██████████████████████
██  ██  ██          ██                      ██  ██
██  ██████████████  ██████  ██  ██████████████  ██
██  ██      ██          ██  ██          ██  ██  ██
██████████  ██████  ██████  ██  ██████████  ██  ██
██      ██  ██          ██  ██                  ██
██████  ██  ██████  ██████████  ██  ██  ██  ██  ██
██                          ██  ██  ██  ██  ██  ██
██████  ██████  ██  ██  ██████  ██  ██████████  ██
██  ██  ██      ██  ██      ██  ██      ██      ██
██  ██████  ██  ██  ██  ██  ██  ██  ██████████  ██
██          ██  ██  ██  ██  ██  ██  ██            
██████████████████████████████████████████████████
██████████████████████████████████████████████████